NO ./wolf_textures/north.xpm
SO ./wolf_textures/south.xpm
WE ./wolf_textures/west.xpm
EA ./wolf_textures/east.xpm

F 120,120,120
C 90,90,90

11111
10101
11N11
10101
11111